0000000000000000
0000000000000000
0000000000000000
00000hi11f000000
1211111111221111
1b14411nnnnn411f
1444111n333n1111
nn11412nnnnn1211
3n4411o111144122
3n44111111111111
3no41111f11112b2
nn44114411411112
1b1111144411414n
2122222111411n33
21111*2111444n33
22222221111o1nnn