0000000000000000
0000000000000000
0000000000000000
000000000h000000
1111b1b3bi241142
1f4114n341n31114
14114n44o2411nn2
31nn431121414431
4143211441411141
4n11onn411121113
23*nf43n41421211
1233412431411211
n2414o4421441114
2321142244b1141o
2112241411111441
14134b1234111321
