0000000000000000
0000000000000000
0000000000000000
000000h000000000
111311i4414b4b11
441114n4n44nn141
44141o3bb3143141
4o1nn24114221f11
n34n3nn22o121414
44f41n314411141o
2121441114422f41
4n411121nn1f4n31
3f311bn423144n3o
12nn11n31414223f
4123241411b411o4
142121411111*422
