0000000000000000
0000000000000000
0000000000000000
00000000000h0000
14412111211if411
14f44o24f1111114
nnn34n4111421422
432f4432444no431
1nn3112342123112
2234n414n3141nn1
nn24311124142n3f
4314bb4n211*1141
1n41112n3o144122
4o3111214312o241
4411b1411b141ff4
o31o214113231431
