0000000000000000
0000000000000000
0000000000000000
000h000000000000
321i4ofnfn421331
1122n4n344341114
11fn314341444n21
114b11b3444nb3o4
f444444422431111
11111241144n1112
1111411411n31241
3nnf42*44111n411
1n31111441414314
41141112b1111444
11f1111411211411
414o11114f41o341
