000000f112o11n33
0000000442111nnn
00000014122nn112
00000hi1b223nn22
00000001nn333412
00000111443nnn11
000441144onn1114
0000111111122*41
0000014f112b1242
00000021111111b1
0000002141421111
0000011114122111
101111111nnn2222
201211241n0f1b21
000144b21nnn1444
00001411111o1144