0000000000000000
0000000000000000
0000000000000000
000000000h000000
1111b1b1bi241142
1f41141141111114
14114n44o2411nn2
11nn331121414431
41433n1441411141
4nnnon1411121113
2n*nf41141421211
1233412431411211
n2414o4421441114
2421142244b1141o
2112241411111441
14114b1204111121
