0000000000000000
0000000000000000
0000000000000000
000000h000000000
111411i4414b4b11
441114n3n44nn141
44141o33b3141141
4o1nn33n14221f11
114n3nn22o121414
44f41n214411141o
2121441114422f41
44411121441f4111
1f111bn421144112
12o111441414223f
412b241411b411o4
142121411111*422
