0000000000000000
0000000000000000
0000000000000000
00000000000h0000
14412111211if411
14f44o24f1111114
11144n4111421422
422f4432444no431
1n33n12o42123112
2233n41412141221
nn233n112414211f
41n4bb4n211*1141
1n4111211o144122
4o2111214212o241
4411b141nbn4nff4
o21o2141n333n411
